XXXXXXXXXXXXXXXXXXXXXXXXXXX 
XMQQTQQQQQXOTQQQQXXGQQQQQOX
XQXXXQXXQXXXXQXXQXXXXXXQXXX 
XTXXXQQQQQQQQQQXQQXXXXQQQXX 
XQQQQQXQXXXQXXQXXQXXXXQXQXX 
XQXXXQQQQTQQQQQQQQQQQQQXQQX 
XQXXXQXXXXQXXXQXXTXXXXXXXQX 
XQQQQQQTQQQQTQQXXQQQQQQTQQX 
XQXXTXXXQXXXXQXXXQXXXXXXQXX 
XQQQQQQQQQQQQOXXXQQGQQQQQXX 
XXXXXXXXXXXXXXXXXXXXXXXXXXX 