XXXXXXXXXXXXXXXXXXXXXXXXXXX
XMTQQQXQQQQQTOQQQXXXXXXQQGX 
XQXQXQXQQXQXXQXXQXXXXQQQXXX   
XQXQXQXTXXQXXQQQTQXXQQXQQQX   
XQXQQQQQQQQXXXXXXQXXXXXQXQX   
XQXQXXXXXXQQQQQQXQQQQQQOXQX
XQXQQQQQXXQXXQXQXQQQXQXXXQX
XQQQQQXQXXQXXQXQQQXXXQXXQQX
XQXQXXXQXXTXXQXXXQQQQQQXQQX
XQQQQQQQQQQQQQXXXXXXXXQOQQX
XXXXXXXXXXXXXXXXXXXXXXXXXXX