XXXXXXXXXXXXXXXXXXXXXXXXXXX
XOGQQQQQTQQQQQQQQQQQQQQQGOX
XQXQXXXQXQXXXXXTXXXQXXXQXQX
XQXQQQTQQQQQTQQQQQQQXXXTXQX
XQXXXXXQXXXXXQXXXXXQXXXQQQX
XQTQQQTQQQQQQMQQQQQQXXXQXQX
XQXQXQXQXXXXXXXQXXXTXXXQTQX
XQQQTQQQXXXXXGXQQQQQQQQQXQX
XQXXXQXXXXXXXOXXXXXTXXTXXQX
XQGOXQQQQQQQQQQQQQQQQQQQGOX
XXXXXXXXXXXXXXXXXXXXXXXXXXX
