XXXXXXXXXXXXXXXXXXXXXXXXXXX
XMQQXXXXQQQQQQQQQQQXXXXQQQX
XQXQOQTQQXXXXXXXXXQQTQOQXQX
XQXXXXXGXXXQQQQQXXXXXQXQXQX
XQQQQQQQQQTQXQXQTQQQQQQQQQX
XXXXXXXTXXXQXXXQXQXXXXXXXXX
XQQQQQQQQQTQXQXQTQQQQQQQQQX
XQXXXXXQXQXQQQQQXQXTXXQXXQX
XQOQQQXQXQXXXXXXXQXQQQQQOQX
XXQXXQXQQQQQQQQQQQXQXQXXQXX
XXXXXXXXXXXXXXXXXXXXXXXXXXX