	XXXXXXXXXXXXXXXXXXXXXXXXXXX
	XMTQQQXQQQQQTOQQQXXXXXXQQGX 
		XQXQXQXQQXQXXQXXQXXXXQQQXXX   
	XQXQXQXTXXQXXQQQTQXXQQXQQQX   
		XQXQQQQQQQQXXXXXXQXXXXXQXQX   
			XQXQXXXXXXQQQQQQXQQQQQQOXQX
	XQXQQQQQXXQXXQXQXQQQXQXXXQX
		XQQQQQXQXXQXXQXQQQXXXQXXQQX
	XQXQXXXQXXTXXQXXXQQQQQQXQQX
	XGQQQQQQQQQQQQXXXXXXXXQOQGX
	XXXXXXXXXXXXXXXXXXXXXXXXXXX