XXXXXXXXXXXXXXXXXXXXXXXXXXX 
XMQQTQQQQQXOQTQQTQXGQQQQQOX 
QXXXQXXXQXXXXQXXQXXXXXXQXXX 
XTXXXQQQQQQQQQQXXQXXXXQQQXX 
XQQQQQXQXXXQXXQXXQXXXXQXQXX 
XQXXXQQQGTQQQQQQQQQGQQQXQQX 
XQXXXQXXXXQXXXQXXTXXXXXXXQX 
XQQQQQQTQQQQTQQXXQQQQQQTQQX 
XQXXTQQQQXXXXQXXXQXXXXXXQXX 
XQQQQQQQQQQQQOXXXQQGQQQQQXX 
XXXXXXXXXXXXXXXXXXXXXXXXXXX 