XXXXXXXXXXXXXXXXXXXXXXXXXXX
XMQQXXXXQQQQQQQQQQQXXXXQQQX
XQXQOQTQQXXXXXXXXXQQTQOQXQX
XQXXXXXQXXXQQQQQXXXXXQXXXQX
XQQQGQQQQQTQXQXQTQQQQQGQQQX
XXXXXXXTXXXQXXXQXQXXXXXXXXX
XQQQQQQQQQTQXQXQTQQQQQQGQQX
XQXXXXXQXQXQQQQQXQXTXXXXXQX
XQOQQQXQXQXXXXXXXQXQQQQQOQX
XXQXXQXQQQQQQQQQQQXQXQXXQXX
XXXXXXXXXXXXXXXXXXXXXXXXXXX