XXXXXXXXXXXXXXXXXXXXXXXXXXX
XOGQQQQQTQQQQQQQQQQQQQQQGOX
XQXQXXXQXQXXXXXTXXXQXXXQXQX
XQXQQQTQQQQQTQQQQQQQXXXTXQX
XQXXTXXQXXXXXQQQQQQQXXXQQQX
XQTQQQXQQQTQQMTQQQQQXXXQXQX
XQXQXQXQXXXQXXXQXXXTXXXQTQX
XQQQTQQQXXXXXOXQQQQQQQQQXQX
XQXXXQXXXXXXXGXXXXXTXXTXXQX
XQGOXQQQQQQQQQQQQQQQQQQQGOX
XXXXXXXXXXXXXXXXXXXXXXXXXXX
